#############
#@-----.----#
####-###--$-#
#*--*-###---#
#.--------$-#
#############