########
#@-#.#.#
#--#$#$#
#------#
########