##########
#@-#.#####
#--#-#---#
#--#$#---#
#.-----$-#
##########